_________________
|PC            D|
|               |
|               |
|               |
|      TV       |  
|      NES      |
|L              |
|I              |
|T______________|