__________
|HH TV  H|
|        |
|        |
|   TA   |
|   BL   |
|        |
|        |
|__  ____|
