   @     @##@     @ 
@@@@@@@@@@##@@@@@@@@
@                  @
@    ___     ___   @
@   /   \   /   \  @
@   |_D_|   |_D_|  @
@                  @
@         _______  @
@        /       \ @
@   @@@@ |       | @
@        |___D___| @
@                  @
@                  @
@        @@@@@@@@@ @
@   ~~~~           @
@   ~~~~           @
@   ~~~~           @
@@  ~~~~@@@@@@@@@@@@
