@     @  @     @
@@@@@@@  @@@@@@@
@              @
@              @
@     @        @
@@@@@@@@@@@    @
@     @########@
@     @########@
@     @########@
@@@@@@@########@
@              @
@              @
@          ####@
@@@@@@@@@@@####@
@          ####@
@          ####@
@              @
@              @
@              @
@@ @@@@ @@@@@@@@
@              @
@              @
@        ####  @
@@@@@@@@@####@@@
@        ####  @
@        ####  @
@              @
@@@   @@@@@@@@@@
@  ####    ####@
@  ####    ####@
@####    ####  @
@####    ####  @
@@@@@@@##@@@@@@@
@     @##@     @
@     @##@     @
@     @##@     @